############### 
#     OOO     # 
#  M   M   M  # 
#    M   M    # 
#  M   M   M  # 
#             # 
#             # 
#             # 
#      A      # 
############### 
